NO ./utils/textures/wall_1.xpm
SO ./utils/textures/wall_2.xpm
WE ./utils/textures/wall_3.xpm
EA ./utils/textures/wall_4.xpm
F 0,0,0
C 105,105,105

1111111
1000001
1011101
1000101
1010001
1000S01
1111111