NO ./textures/north_texture.xpm
SO ./textures/south_texture.xpm
WE ./textures/west_texture.xpm
EA ./textures/east_texture.xpm
F 100,150,255
C 50,50,50

1111111
1E00001
1011101
1000101
1010001
1000S01
1111111