NO ./utils/textures/wall_1.xpm
SO ./utils/textures/wall_2.xpm
WE ./utils/textures/wall_3.xpm
EA ./utils/textures/wall_4.xpm
F 220,100,0
C 225,30,0

1111111111
1000000001
1011111101
1000000101
1010110101
1000100101
1010100101
1000000S01
1111111111